####################################################################
#..................................................................#
#..................................................................#
#..............#####################################...............#
#..............#...................................#...............#
#..............#...................................#...............#
#..............#...................................#...............#
#..............#...................................#...............#
#..............#...................................#...............#
#..............#########...........................#...............#
#..................................................#...............#
#..................................................#...............#
#..................................................#...............#
#..................................................#...............#
#..............................#####################...............#
#......#############...............................................#
#..................................................................#
#..................................................................#
#..................................................................#
#...................#########......................................#
#...................#..............................###########.....#
#...................#..............................#...............#
#...................#..............................#...............#
#...................#..............................#...............#
#...................#..............................#...............#
####################################################################