####################################################################
#..................................................................#
#..................................................................#
#..............#####################################...............#
#..............#...................................#...............#
#..............#...................................#...............#
#..............#......................##############...............#
#..............#...................................#...............#
#..............#...................................#...............#
#..............#########...........................#...............#
#..................................................#.........#.....#
#..................................................#.........#.....#
#..................#...............................#.........#.....#
#..................#...............................#.........#.....#
#..................#...........#####################.........#.....#
#......#############...................#.....................#.....#
#........#.............................#.....................#.....#
#........#.............................#.....................#.....#
#........#.............................#.....................#.....#
#........#..........#########................................#.....#
#........#..........#..............................###########.....#
#........#..........#..............................#...............#
#........#..........#..............................#...............#
#...................#..............................#...............#
#...................#..............................#...............#
####################################################################